11111111111111111111111111111111111111
1C1P100000000F0000000000000000F0000001
1C10100010FFFF000000000000000000000001
1C1010E0100000000000C00000000000000001
1C1010001000000000000000000000000C0001
1C10111110000000000000000C000000000001
1C10F000F00000C00000000000000000000001
1C10F0C0F00000000000000000000000000001
1C10F0C0F0000000000000000000C000000001
1C10F000F0000000000CC00000000F00000001
1C10FFFFF0000000000CC00000000000000001
1C100000000000F00000000000000000000001
1C100000000000000000000000000000000001
1C100000000000000000000F00000000000001
1C1000FC000000000000000000000000000001
1CC00000000000000CCC000000000000000001
11111111111111111111111111111111111111
