1111111111111111111111111111111111
1E0000000000000C000F0C0000000000F1
10100101001000001010010F0000010101
1010F1001010101F001001000F00010101
1P00000F0C00C00000000000000F0000C1
1111111111111111111111111111111111
