1111111111
1000000001
10100001C1
10100001C1
1P1E0001C1
1111111111
