11111111111111111111111111111111111111111111111111111111111
100P00000000C0000000000000000000000000000000000000000000001
10000000000000000000000000000000000000000000000000000000001
10000000000000000000000000000000000000000000000000000000001
1000000F00000000F0000000000000C00F0000000000C00000000000001
1000000000000000000000000000000000FFF0000000000000000000001
100000000C0000000000000000000000000000000000000000000000001
100000000000F0000C0000000000000000000000000000000C000000001
10000000000000000000000000000000000000000000000000000000001
10000000000C000000000000000000F0000000000C00000000000000001
10000000000000000000000000C00000000000000000000000000000001
10000C000000000C000000000000000C00000000F000000000000000001
100000000000000000000F00000000000C0000000000000000000000001
100000000000000000F0000000000000000000000000000000000000001
10C000000000000000000000000000000000000000000000C0000000001
10000000C0FC00000000000000000C00000C000000F0000000000000001
1000000000000000000C000000000000000000000000000000000000001
100000000000C0000000000000000000000F00000000000000000000001
10000000000000000000000000000000000000000000000000000000001
10000000C0000000000C0000000000000000000000C0000000000000001
100000000000C000000F000000000C000000000F0000000000000000001
10000000000000000000000000000000000000000000000000000000001
1000F00000000000CC00000000000000000000000000000C00000000001
100000000000000000000000000000000000000000000000000F0000001
100000000000000000000C000000000000000C00000000000000C000001
10000000000000F0C00000000000000000E0000C0000000000000000001
10000000C00000000000000000000000000000000000000000000000001
10000000000000000F0C0000000F000C000000000000000000000000001
1000000000000000000000000000000000000F00C000000000000000001
10000000000000C000C0000000000000000000000000000000000000001
100000F000000000F00000000000000000C00000000000000C000000001
10000000000C0000000000000C0000000000000000000000000C0000001
10000000000000C000000000C000C000000000000000000000000000001
10000000000F00000000000000000000000000000000C00000000000001
1000000000000000000000000000000000F000000000000000000000001
11111111111111111111111111111111111111111111111111111111111
